111111111111111111111111111111
1P00000C00C0000C00E0000C000001
111111111111111111111111000001
111111111111111111111111000001
111111111111111111111111000001
111111111111111111111111000001
111111111111111111111111000001
111111111111111111111111000001
111111111111111111111111000001
111111111111111111111111000001
111111111111111111111111000001
111111111111111111111111000001
111111111111111111111111000001
111111111111111111111111000001
111111111111111111111111000001
111111111111111111111111111111
