1111111111111111
1100000PCE001111
1111111111111111