1111111111111111
10000000CEP11C11
1111111111111111