1111111111111111
10000000CE1P1111
1111111111111111