1111111111111111
10000000CEP11111
1111111111111110