1111111111111111
10000C0P0E111111
1111111111111111