1111111111111111
100000000CEP1111
1111111111111111