1111111111111111
1000000PCE111111
1111111111111111